



   
F    40     , 123 , 56

C    76, 187, 217





   WE ./assets/textures/wall.xpm
  EA   ./assets/textures/wall.xpm

NO ./assets/textures/wall1.xpm
SO ./assets/textures/wall1.xpm



1111111111111111111111111
1000000000000000000000001
11111111101DD111111111111
10000000000N0000000000001
1000000000000000000000001
1000000000000000000000001
1111111111111111111111111





