

   
F 40, 40, 40

C    10, 20, 30





   WE ./assets/textures/wall.xpm
  EA   ./assets/textures/wall.xpm

NO ./assets/textures/wall.xpm
SO ./assets/textures/wall.xpm


1111111111111111
1000000N00000001
1111111111111111

