

   
F 40, 40, 40

C    10, 20, 30





   WE ./assets/textures/wall.xpm
  EA   ./assets/textures/wall.xpm

NO ./assets/textures/wall.xpm
SO ./assets/textures/wall.xpm
111111111111111111111111111
100000000000000000000000001
111111111111111111110111111
11111111111       110111111
10000000000111111111N111111
1111111111111111111111111111