






F 40, 40, 40

C    10, 20, 30





   WE ./assets/textures/wall.xpm
  EA   ./assets/textures/wall.xpm

NO ./assets/textures/wall.xpm
SO ./assets/textures/wall.xpm






1111111111111111111111111111                        1111111111111111111111111111
1000000000000000000000000001                        1000000000000000000000000001    11111111111111111111
1000000000000000000000000001                        1000000000111111110000000001   1100000000000000000111
1000000000000000000000000001                        10000000001      10000000001  110000000000000000000011
100000000000000000000000000111111111111111111111111100000000001      100000000011110000000000000000000000111111111111
100000000000000000000000000000000000000000000000000000000000001      100000000000000000000000000000000000000000000001
100000000000000000000000000111111111111111111111111110000000001111111100000000111110000000000000000000001111111111101
1000000000000000000000000001                        1000000000000000000000000001  11000000000000000000001         101
1000000000000000000000000001                        1000000000000000000000000001   1100000000000000000011         101
1111111111101111111111111111                        1111111111111011111111111111    11111111111111111111          101
          101                                                   101                                               101
          101                                                   101                                               101
          101                                                   101                                               101
          101                                                   101                                               101
          101                                                   101                                               101
          101                                                   101                                               101
          101                                                   101                                               101
1111111111101111111111111111                        1111111111111011111111111111                                  101
1000000000000000000000000001                        1000000000000000000000000001      111111111111                101
1000000000000000000000000001                        1000000000000000000000000001      100000000001                101
1000000111111111000000000001                        1000000000000000000000000001      1000000000011111111111111111101
10000001       10000000000011111111111111111111111111000000000000000000000000001      1000000000000000000000000000001
10000001   1   10000000000000000000000010000000000000000000000000000000000000001      1000000000011111111111111111101
10000001       10000000000011111111111111111111111111000000000000000000000000001      100000000001                101
1000000111111111000000000001                        1000000000000000000000000001      111111111111                101
1000000000000000000000000001                        1100000000000000000000000001                                  101
1111111111101111111111111111                        1111111111111011111111111111                                  101
          101                                                   101                                               101
          101                                                   101                                         1111111011111111
          101                                                   101                                        1100000000000000111
          101                                                   101                                       110000000000000000011
          101                                                   101                                      11000000000000000000011
          101                                                   101                                     1100000000000000000000011
          101                                                   101                                   11100000000000000000000000111
1111111111101111111111111111                        11111111111110111111    1111                     1100000000111111111110000000011
1000000000100011101000000001                        10000000000000000001    1001                    110000000001  1T0T1   100000000011
1000010111100010101111000001                        1000000000000000000111111001111111111111111111111000000000011D1111111100000000011
100001000000001010000001111111111111111111111111111110000000000011111100000000000000000000000000000000000000000TT0TTNTTTTT00000000011
10000111111111101000000100000000000000000000000000000000000000001    100000000011111111111111111111111TTTTT000011111D11111TTTTT000001
10000000000000001000000100011111111111111111111111111000000000001    10000000001                    111TTTTT0001   101   1TTTTT000111
1000000001110111101111110001                        1000000000001    10000000001                      11100000011111011111000000111
1000000001000000000000000001                        1000000000001    10000000001                        1110000000000000000000011
1000000001000000000000000001                        1000000000001    10000000001                         110000000000000000000011
1111111111111111111111111111                        1111111111111    11111111111                          1111111111111111111111