
F 0,002, 2
C 225,30, 4




WE ./textures/a.xpm
EA ./textures/a.xpm
NO ./textures/a.xpm
SO ./textures/a.xpm



1111111111111111111111111
1000000000110000000000001
1011000001110000000000001
100100000000000000000000111111111
111111111011000001110000000000001
100110000110000011101111111111111
11110111111111011100000010001
11110111111111011101010010001
11000000110101011100000010001
11000011110111011111011110N0111
11110111 1110101 101111010001
11111111 111111 111111111111
111111111111111111111111111111
111111111111111111111111111111
111111111111111111111111111111