



   
F     1,0,2
C     225,55,30






   WE ./textures/a.xpm
  EA   ./textures/a.xpm
       
NO ./textures/a.xpm
SO ./textures/a.xpm


111111111111111111111111111111111111111111
100000000011000000000000100001
1011000001110000000000001111111
10010000000000000000000011111111111111111111111111
111111111011000001110000000000001
100000000011000001110111111111111
11110111111111011100000010001
11110111111111011101010010001
11000000110101011100000010001
10000000000000001100000010001
1000000000N000001101010010001
110000011101010111110111100111
11110111 1110101 101111010001111111111
11111111 1111111 11111111111111111111111111111111
11111111111







